00000000000000000000111111111111111111111111111111111111111100000000000000000000
00000000001110000000111111111111111111111110010000011111111100000000000000000000
00000011111011000000111000000000000000111111000010001111111100000000000000000000
00000110011001100000111000000000000000000111111110000011111100000000000000000000
00000100011000100000111001111111111110000001111111100000011100000000000000000000
00000110000001100000111001000000000010000000000001100000001100000000000000000000
00000010000001000000111001000000000010111110000001100010001100000000000000000000
00000010000001000000111001001111111110111111111001100011001100000000000000000000
00000010000001000000111001001000000000111111111001100011000100000000000000000000
00000011100111000000111001001000000000111111110001100011000100000000000000000000
00000001100110000000111001001001111110111111110001100011001100000000000000000000
00000001000010000000111001001001001000111111110001100011001100000000000000000000
00000001100010000000111001001001001000111111110000000011000100000000000000000000
11111111000011111111111001001001001001111111110000000000000100000000000000000000
10000000000000000001111001001001001001111111111100000000111100000000000000000000
10000000000000000001111001111001111001111111111111111110111100000000000000000000
10000000000000000001111001111001111001111111111111111110111100000000000000000000
10000000000000000001111001111001111001111000000011111100100100000000000000000000
10000000000000000001111000000000000000011101110011100000011100000000000000000000
10000000000000000001111111111111111111011101111011100000001100000000000000000000
10000000000000000001110000000000000000011000111000000000001100000000000000000000
10000000000000000001110011111111111111111000100000000000001100000000000000000000
10000000000000000001110000000000000000011000101100000000001100000000000000000000
10000000000000000001110000000000000000011101111101110111011100000000000000000000
10000000000000000001111111111111111100011101111111111111111100000000000000000000
10000000000000000001110000000000000100011101110111111111111100000000000000000000
10000000000000000001110000000000000100011000000100001011000100000000000000000000
10000000000000000001110000000111111100011000010100000011000100000000000000000000
10000000000000000001110000000100000000011000010101100000000100000000000000000000
10000000000000000001110000000100000000011001010101111000011100000000000000000000
10000000000000000001110000000100000000011000000001111100111100000000000000000000
10000000000000000001111111111101111111111111111111111100111100000000000000000000
10000000000010000001111111111101111111111111111111111100111100000000111100000000
10000000000000000001110000000000000000011001111111111100000100000001111110000000
10000000000000110001110001111111111111011001111111111100000100000001100110000000
10000000000000001001110011000000000000011000000111111000000100000001100110000000
10000000000000000001110100001111111111111000000111111000000100000001000010000000
10000000000000000001110111111000000000111000000000000000000101111111100111111110
10001000000000000101110000000010101110111000000000000000000101000001100110000010
10010000000000100001111001111101010000111000110001100011000111000001100110000011
10010100000000000001110111000000000111011000110001100011000111000001100110000011
10010000000100001001111000010110110101011000000001100000000111110111100111101111
10100000000100000001111100111011101010011000000111111000000111000000100100000011
10010000000001000001111000100000000011011000000111111000000111000000100100000011
10100100000000000011111100110011111001011000000011110000000111000000100100000011
10000000000100010001111110010100000000111000110011110011000110000000100100000001
10000000000001000000000011000101101101111000110000000011000110000000100100000001
11101100000000110111111111111101111111111111111111111111011111111110100100001111
11101100000000110111111111111101111111110000000000000001011111111110100110001100
11001100000000110011110000000000000000010111111100000001011110110000000010001100
11001100000000110011110100000000000001010100000100000111010110000010000010001000
11100110000001100111110000000000000000010101110111111100000110000010011010001000
11100110000001100111110000000000000000010101010000000000000110101111100010001000
11110000000011001111110000000111000000010100000000000000001110101111100010001000
11110000000011001111110000001111100000010100000111111000001110101101100010001000
11101101100000000001110000001111100000010101111100001000011110101000100010001000
11101101100000000001110000000111000000011101100000001000011110111000111110001000
11000000001100000001110000000000000000011000100000001000000000000010000000001000
11000000001100000011110000000000000000011111100000001000011111111111111110001000
11100000000000000000000100000000000001010000111111111101110000001111100010001000
11111100000000000001110000000000000000010001100000000000010000001111100011111000
11010000000000000001110000000000000000010001000000000000010000000000000000000000
11011100000000000001111111111111111111110001100000000000010000000000000000000000
11111111111110110111111111111111111111110000111111111111111100000000000000000000
11111111111110110111000000000000000000000000000000000000000000000000000000000000
11111000011000000001000000000000000000000000000000000000000000000000000000000000
11010011011000000001000000000000000000000000000000000000000000000000000000000000
11000100011110001111000000000000000000000000000000000000000000000000000000000000
10111110111111011111000000000000000000000000000000000000000000000000000000000000
10000000011000001001000000000000000000000000000000000000000000000000000000000000
11011000111000000001000000000000000000000000000000000000000000000000000000000000
11011111111000110001000000000000000000000000000000000000000000000000000000000000
11011111111000110001000000000000000000000000000000000000000000000000000000000000
11000000000000000001000000000000000000000000000000000000000000000000000000000000
11000000000000000001000000000000000000000000000000000000000000000000000000000000
11000000000000000011000000000000000000000000000000000000000000000000000000000000
10100110000000011011000000000000000000000000000000000000000000000000000000000000
11100110011000011011000000000000000000000000000000000000000000000000000000000000
11100000011000000011000000000000000000000000000000000000000000000000000000000000
11111111111111111111000000000000000000000000000000000000000000000000000000000000
