11111111111111111111
10111111111111111111
10000000000001111111
10000000000001111111
10011000000001111111
10001110111000000001
10001110111000001001
10000000111000111111
10000000111000111111
10000000111000111001
10111000111000110001
10111000111111110111
10111000111111110111
10000010000000000011
10000000000000000001
10000000000000000001
10000000000000000001
10000000000001111101
10010010000001111101
10001100000001111101
10001100000001111101
10010010000001101101
10000000000000000001
10000000011011111101
10000000011011111101
10000000011011111101
10000000011001111001
11100011111000000001
11100011111110000111
11111111111111111111
11111111111111111111
11111111111111111111